NO ./texture/wall_n.xpm
SO ./texture/wall_s.xpm
WE ./texture/wall_w.xpm
EA ./texture/wall_s.xpm
F 45,100,000
C 25,30,0
111111111111                   11111111
100001000001111111111111111111110000001
10000D00W000000000000000000000000000001
111101000000000000000000000000000000001
   101111111000000000000000000000000001
   101     1000000000001100000000001111
   101     1111000000111111000000001111
111101111111000000000011110000000001111
1001Z1010000000000000000000000000000001
100111010000000000Z00000000000000000001
100000011111110000000011111111110000001 
10000001     1000000001        10000001
10000001     1000000001        10000001
100000001111100000000001111111100000001
100000000000000000000000000000000000001111111111111111111111
100000000000000000000000000000000000000000000000000000000001
1000000000Z0000000Z000000Z0000000Z00000000Z0000000Z000000001
100000000000000000000000000000000000000000000000000000000001
111111111111111000000000000111111111100000000000011111110001
              10000000000001        10000000Z00001     10001
              10000000000001        10000000000001     10001
111111111111111000000000000111111111100000000000011111111111
10000000000000D000000000000100000000100000000000000000000001
1000000000000010000000000001000000001000000000000Z0000000001
100Z00000000001000000000000100000000100000000000000000000001
1000000Z000000100000000000000000000000000000000000000Z000001
100000000000001000000000000Z00000000000000000000000000000001
111111111111111111111111111111111111111111111111111111111111