NO ./texture/Coree.xpm
SO ./texture/wall.xpm
WE ./texture/wall.xpm
EA ./texture/wall.xpm
F 125,100,0
C 225,30,0
11111111111
10000000001
1000W000001
10000000101
11111010001
10000010001
10000000001
11111111111
