NO ./texture/wall2.xpm
SO ./texture/wall2.xpm
WE ./texture/wall2.xpm
EA ./texture/wall2.xpm
F 34,32,52
C 20,30,0
11111111111
10000000001
10N01000Z01
10000000101
11111D10001
100Z0010001
100000D0001
11111111111
