NO ./texture/wall2.xpm
SO ./texture/wall2.xpm
WE ./texture/wall2.xpm
EA ./texture/wall2.xpm
F 34,32,52
C 20,30,2

11111111111
10000000001
10001000Z01
100000N1101
11111D10001
10000010001
100000D00
11111111111