NO ./texture/wall-4-set2.xpm
SO ./texture/wall-2-set2.xpm
WE ./texture/wall2.xpm
EA ./texture/wall-1-set2.xpm
F 45,100,0
C 25,30,0
        1111111111111111111111111
        100000000011000000000N001
        1011000001110000000000001
        1001000000000000000000001 
111111111011000001110000000000001
100000000011000001110111111111111
11110111111111011100000010001
111101111111110DDD01010010001
11000000110101011100000000001
10000000000000001100000010001
10000000000000001101010010001
11000001110101011111011110011
11110111 1110101 101111010001
11111111 1111111 111111111111