NO ./texture/wall.xpm
SO ./texture/wall.xpm
WE ./texture/wall.xpm
EA ./texture/wall.xpm
F 125,1,0
C 20,30,0
11111111111
10000000001
1000W000Z01
10000000101
11111D10001
100Z0010001
100000D0001
11111111111
