NO ./texture/Coree.xpm
SO ./texture/France.xpm
WE ./texture/wall.xpm
EA ./texture/wall.xpm
F 125,100,0
C 225,30,0
11111111111
10000000001
1000W000001
10000000101
11111D10001
10000010001
100000D0001
11111111111
