NO ./texture/wall2.xpm
SO ./texture/wall2.xpm
WE ./texture/wall2.xpm
EA ./texture/wall2.xpm
F 34,32,52
C 20,30,0
1111111111111111111111111111111111111111111111111111111111111111111111111111111111111111111111111111111111
1000000000000000000000000000000000000000000000000000000000000000000000000000000000000000000000000000000001
1111111111111111111111111111111111111111111111111111111111111111111111111111111111111111111111111111111111