11111111111
10000000001
1000000000001
100N0000101
10000010001
10000010001
10000010001
11111111111