11111111111
10000000001
10N00000001
10000000101
11111D10001
10000010001
100000D0001
11111111111