11111111111
10000000001
100N0000001
10000000101
11111210001
10000010001
10000020001
11111111111