NO ./texture/wall_n.xpm
SO ./texture/wall_s.xpm
WE ./texture/wall_w.xpm
EA ./texture/wall_e.xpm
F 34,32,52
C 20,30,2

11111111111
100000000Z1
10001000Z01
100000S0101
11111D10001
10000010001
10000ZD0101
11111111111