NO ./texture/wall_e.xpm
SO ./texture/wall_n.xpm
WE ./texture/wall_s.xpm
EA ./texture/wall_w.xpm
F 34,32,52
C 20,30,0
1111111111111111111111111111111111111111111111111111111111111111111111111111111111111111111111111111111111
1000000000000000000000000000000000000000000000000E00000000000000000000000000000000000000000000000000000001
1111111111111111111111111111111111111111111111111111111111111111111111111111111111111111111111111111111111